NO ./textures/wood.xpm
SO ./textures/brick.xpm
WE ./textures/stone.xpm
EA ./textures/metal.xpm
S  ./textures/barrel.xpm

R 780 780

F 250, 100, 0

C 225, 30, 0

11111111111111111111
10000000000000000001
1000N000000000000001
10000000000022000001
10000000000000000001
11111111111111111111

