WE ./textures/stone.xpm
SO ./textures/brick.xpm
NO ./textures/wood.xpm
EA ./textures/metal.xpm

S  ./textures/barrel.xpm
F 220,100,30
C 30,100,220

R 780 780

1111111111111111
1110111
100001111111111111111
100000000000000000011
10000N000000200000011
100000000000220000011
100000000000000000011
111111111111111111111
