SO ./textures/brick.xpm
WE ./textures/stone.xpm
NO ./textures/wood.xpm
EA ./textures/metal.xpm

S  ./textures/barrel.xpm
F 200, 100, 10
C 30, 100, 200


R 800 800

111111
1111111111111111
1110111
100001111111111111111
100000000000000000011
100000000000000000011
100000000000000000011
100000000000000000011
100000000000000000011
100000000000000000011
100000000000002000011
100000000000002000011
100000000000000000011
100000000000000000011
100000000000000000011
1000220000000000000001
100000000000000000011
100000000000000000011
100000000000000000011
100000000000000000011
100N00000000000000011
100000000000000000011
100000000000000000011
111111111111111111111

