SO ./textures/brick.xpm
NO ./textures/wood.xpm
WE ./textures/stone.xpm
EA ./textures/metal.xpm

S  ./textures/barrel.xpm
F 200, 100, 10
C 0, 0         , 0hewfj


R 800 800

111111
11111111111111
1110111                                   
100001111111111111111
100000000000000000011
10000000000000000001
111111111111111111111
111111111111111111111
100000000000000000011
100000111100000000011
1000001  100000000011
1000001  10000000011
100000111100002000011
100000000000002000011
100000000000000N00011
100000000000000000011
100000000000000000011
100022000000000000001
100000000000000000011
100000000000000000011
100000000000000000011
100000000000000000011
100000000000000000011
100000000000000000011
100000000000000000011
111111111111111111111
